Chant_AiryAura	SAPPHIRE
Chant_AnimalFriendship	FISH
Chant_AnimalGrowth	BEEF
Chant_Barkskin	WOOD
Chant_Bloodhound	PEPPERS
Chant_BreatheAir	POULTRY
Chant_BreatheWater	SEAWEED
Chant_Brittle	MUSHROOMS
Chant_CalmAnimal	CARROTS
Chant_CalmSeas	LIMESTONE
Chant_CalmWind	SANDSTONE
Chant_Camelback	MUTTON
Chant_CatsGrace	QUARTZ
Chant_ChargeMetal	WOOL
Chant_CharmAnimal	MEAT
Chant_Darkvision	CARROTS
Chant_Drifting	LIMESTONE
Chant_EelShock	WOOL
Chant_EndureRust	COPPER
Chant_EnhanceBody	EGGS
Chant_Farsight	GLASS
Chant_FertileCavern	GREENS
Chant_Fertility	STRAWBERRIES
Chant_Fertilization	GREENS
Chant_Flippers	LEATHER
Chant_FortifyFood	SALT
Chant_FurCoat	FUR
Chant_Goodberry	BERRIES
Chant_GrowClub	OAK
Chant_GrowFood	CORN
Chant_HardenSkin	GRANITE
Chant_Hawkeye	CARROTS
Chant_Hippieness	PIPEWEED
Chant_Hunger	SAND
Chant_IllusionaryForest	GREENS
Chant_LocateAnimals	BLOOD
Chant_LocatePlants	GREENS
Chant_MeteorStrike	FLINT
Chant_MuddyGrounds	DIRT
Chant_NeutralizePoison	HERBS
Chant_PlantMaze	NUTS
Chant_PredictWeather	COPPER
Chant_RepelVermin	ASH
Chant_ResuscitateCompanion	COPPER
Chant_Root	WOOD
Chant_SenseAge	REDWOOD
Chant_SenseFluids	YEW
Chant_SenseGems	TEAK
Chant_SenseLife	PINE
Chant_SenseMetal	SPRUCE
Chant_SenseOres	SYCAMORE
Chant_SensePlants	BAMBOO
Chant_SensePoison	WILLOW
Chant_SensePregnancy	BEECHWOOD
Chant_SenseWater	ELM
Chant_Shillelagh	HICKORY
Chant_SnatchLight	EBONY
Chant_SnuffFlame	CITRINE
Chant_SoaringEagle	FEATHERS
Chant_SpeakWithAnimals	JADE
Chant_SummonAnimal	MEAT
Chant_SummonInsects	TOMATOES
Chant_SummonJellyfish	FISH
Chant_SummonMount	APPLES
Chant_Thorns	WOOD
Chant_UnderwaterAction	IVORY
Chant_WarpWood	PUMICE
Chant_WaterWalking	BALSA
Chant_WindColor	ALEXANDRITE
Prayer_AnimateGhoul	MESQUITE
Prayer_AnimateSkeleton	BONE
Prayer_AnimateZombie	MEAT
Prayer_BirdsEye	AGATE
Prayer_BladeBarrier	PLATINUM
Prayer_Bless	PEARL
Prayer_Blindness	LAPIS
Prayer_Blindsight	RUBY
Prayer_CallUndead	REED
Prayer_Calm	CEDAR
Prayer_CauseCritical	EMERALD
Prayer_CauseExhaustion	ONYX
Prayer_CauseFatigue	OPAL
Prayer_CauseLight	PERIDOT
Prayer_CauseSerious	CHRYSOBERYL
Prayer_Cleanliness	SOAP
Prayer_CreateFood	WHEAT
Prayer_CreateWater	STONE
Prayer_CureBlindness	CARROTS
Prayer_CureCannibalism	BLACKBERRIES
Prayer_CureCritical	BLUEBERRIES
Prayer_CureDeafness	DATES
Prayer_CureDisease	FRUIT
Prayer_CureExhaustion	BEANS
Prayer_CureFatigue	POTATOES
Prayer_CureLight	GRAPES
Prayer_CureSerious	PLUMS
Prayer_CureVampirism	GARLIC
Prayer_Curse	BLOODSTONE
Prayer_DarkSenses	RUBY
Prayer_Deafness	COCONUTS
Prayer_DeathKnell	MOONSTONE
Prayer_DispelChaos	PLATINUM
Prayer_DispelEvil	SILVER
Prayer_DispelGood	GOLD
Prayer_DispelLaw	BRONZE
Prayer_DivineGuidance	TURQUOISE
Prayer_DivineLuck	PEARL
Prayer_EarthMud	DIRT
Prayer_Ember	COAL
Prayer_Enervate	FLINT
Prayer_FeignLife	SHALE
Prayer_FlameWeapon	COAL
Prayer_Freedom	LIMES
Prayer_FreezeMetal	OPAL
Prayer_Gills	SEAWEED
Prayer_HealUndead	BLOOD
Prayer_HolyWind	CHERRYWOOD
Prayer_Invigorate	ORANGES
Prayer_LightHammer	SILVER
Prayer_LinkedHealth	COCOA
Prayer_Plague	PORK
Prayer_Poison	EMERALD
Prayer_Position	IRON
Prayer_PreserveBody	SALT
Prayer_ProtChaos	ONIONS
Prayer_ProtDisease	LEMONS
Prayer_ProtEvil	PINEAPPLES
Prayer_ProtGood	RASPBERRIES
Prayer_ProtLaw	BOYSENBERRIES
Prayer_ProtOutsiders	CHERRIES
Prayer_ProtParalyzation	OLIVES
Prayer_ProtPoison	SPICE
Prayer_ProtUndead	PEACHES
Prayer_RemoveCurse	SOAPSTONE
Prayer_RemoveDeathMark	SOAPSTONE
Prayer_RemoveParalysis	CRANBERRIES
Prayer_RestoreSmell	ONIONS
Prayer_RestoreVoice	LEMONS
Prayer_SenseAlignment	MAPLE
Prayer_SenseAllergies	CEDAR
Prayer_SenseChaos	BEECHWOOD
Prayer_SenseDisease	PINE
Prayer_SenseEvil	WILLOW
Prayer_SenseFaithful	YEW
Prayer_SenseGood	SPRUCE
Prayer_SenseHidden	REED
Prayer_SenseInjury	BAMBOO
Prayer_SenseInvisible	CHERRYWOOD
Prayer_SenseLaw	SYCAMORE
Prayer_SenseLife	ELM
Prayer_SenseMagic	TEAK
Prayer_SenseProfessions	REDWOOD
Prayer_SenseUndead	MESQUITE
Prayer_SnakeStaff	SCALES
Prayer_Sober	BANANAS
Prayer_UndeadInvisibility	DRAGONSCALES
Spell_Advancement	PLATINUM
Spell_Anchor	LEAD
Spell_Blindness	FLINT
Spell_Blink	GEM
Spell_Blur	COTTON
Spell_ChangeSex	BONE
Spell_Choke	CACTUS
Spell_Clog	STONE
Spell_CombatPrecognition	STEEL
Spell_ComprehendLangs	HICKORY
Spell_Confusion	BARLEY
Spell_DeadenSmell	BLOOD
Spell_Deafness	COPPER
Spell_Delirium	FLOWERS
Spell_Delude	SILVER
Spell_DetectGold	GOLD
Spell_DetectHidden	TOPAZ
Spell_DetectInvisible	CLAY
Spell_DetectMagic	MAPLE
Spell_DetectMetal	TIN
Spell_DetectUndead	PEPPERS
Spell_DetectWater	FUR
Spell_DispelMagic	AQUAMARINE
Spell_FaerieFire	FLINT
Spell_Fear	GLASS
Spell_FeatherFall	FEATHERS
Spell_Feeblemind	SUGAR
Spell_FleshStone	STONE
Spell_Fly	FEATHERS
Spell_Frailty	CLAY
Spell_FreeMovement	BLOOD
Spell_Frenzy	COFFEEBEANS
Spell_GiantStrength	PLATINUM
Spell_GraceOfTheCat	PEARL
Spell_Haste	COFFEEBEANS
Spell_Hold	OBSIDIAN
Spell_Hunger	SILVER
Spell_Immunity	MITHRIL
Spell_ImprovedInvisibility	GLASS
Spell_Infravision	TIN
Spell_InsatiableThirst	SEAWEED
Spell_Invisibility	GLASS
Spell_IronGrip	IRON
Spell_Laughter	IRONWOOD
Spell_Light	SAND
Spell_LightSensitivity	ZINC
Spell_LowerResists	RICE
Spell_MageClaws	BONE
Spell_MagicalAura	MILK
Spell_ManaBurn	HICKORY
Spell_MindBlock	BALSA
Spell_MindFog	COAL
Spell_Mute	CHRYSOBERYL
Spell_Nightmare	BLOOD
Spell_Nondetection	JADE
Spell_ObscureSelf	BALSA
Spell_Polymorph	SCALES
Spell_ResistAcid	BRASS
Spell_ResistArrows	IRON
Spell_ResistCold	FUR
Spell_ResistDisease	AMETHYST
Spell_ResistElectricity	OAK
Spell_ResistFire	SCALES
Spell_ResistGas	LIMESTONE
Spell_ResistMagicMissiles	SCALES
Spell_ResistParalyzation	IVORY
Spell_ResistPolymorph	IVORY
Spell_ResistPetrification	GARNET
Spell_ResistPoison	GRANITE
Spell_Shield	BRASS
Spell_Sleep	SAND
Spell_Slow	VINE
Spell_Spook	BLOOD
Spell_Stoneskin	GRANITE
Spell_Tourettes	HOPS
Spell_WaterBreathing	SEAWEED
Spell_Weaken	HIDE
Spell_WeaknessAcid	RICE
Spell_WeaknessCold	CLAY
Spell_WeaknessElectricity	IRONWOOD
Spell_WeaknessFire	HICKORY
Spell_WeaknessGas	MARBLE
